
UUUUUUUUUUUUUUU
Ub BBBBB MBB  U
U UBU UMU U U U
UM B UUBU     U
UBU U U U U U U
U  BU M  UB BBU
UBU UMUBU UBU U
UBMBBMBB M   BU
UBUBU UUU UMUBU
U  B  U   BBB U
UUUUUUUUUUUUUUU