
UUUUUUUUUUUUUUU
Ub B BBB  BB  U
U UBU UMU UBU U
UM B UUBB  M  U
UBU U U U U U U
U  BU M  UB BBU
UBU UMUBU UBU U
UBBBU BB M   BU
UBUBU UUU UMUBU
U  B  U   BBB U
UUUUUUUUUUUUUUU