UUUUUUUUUUUUUUU
U b       M   U
U UBU UUU UBU U
U  B UBBB  M  U
UBU U U U UBUBU
UM BB MBBUB BBU
UBU U UBU UBU U
UB BU BB M   BU
UBU U U U UUUBU
U  B MU   BBB U
UUUUUUUUUUUUUUU